*********************
* G               G *
* *               * *
* *               * *
* ******** ******** *
* *               * *
* *               * *
*A*       D       *A*
*********************