**********
*  GG    *
*D**G***A*
*   G    *
**********